{
  "lines": [
    "######",
    "#_@$.#",
    "#$_$_#",
    "#._._#",
    "######"
  ]
}
