{
  "1": [
    "########",
    "#______#",
    "#__@$._#",
    "#_$_$__#",
    "#_._.__#",
    "#______#",
    "########"
  ]
}
